[
  {
    "type": "mapgen",
    "method": "json",
    "om_terrain": [ "mapgen-test" ],
    "object": {
      "//": "Some of the squares should have a frame, but not all.",
      "fill_ter": "t_grass",
      "rows": [
        "                        ",
        "                        ",
        "                        ",
        "                        ",
        "                        ",
        "                        ",
        "                        ",
        "                        ",
        "                        ",
        "                        ",
        "                        ",
        "                        ",
        "tttttttt                ",
        "tttttttt       ss oo    ",
        "               ss oo    ",
        "                        ",
        "      X                 ",
        "                        ",
        "T          B           S",
        "                        ",
        "                        ",
        "   ;;;;----gggg         ",
        "   ;;;;----gggg         ",
        " V O . , u fF       Y   "
      ],
      "mapping": {
        "X": {
          "terrain": "t_dirt",
          "traps": "tr_pit",
          "fields": { "field": "fd_fire" },
          "items": {
            "item": "survivorzed_boots",
            "chance": 30
          },
          "item": { "item": "2x4" }
        }
      },
      "place_terrain": [
        { "x": 11, "y": 3, "ter": "t_rock" }
      ],
      "terrain": {
        ".": "t_shrub",
        ";": [ "t_door_o", { "ter": "t_pit_spiked" } ]
      },
      "furniture": {
        ",": "f_table",
        "-": [ "f_chair", { "furn": "f_bed" } ]
      },
      "place_furniture": [
        { "x": 9, "y": 3, "furn": "f_rack" }
      ],
      "place_traps": [
        { "x": 7, "y": 3, "trap": "tr_funnel" }
      ],
      "traps": {
        "F": "tr_cot",
        "f": { "trap": "tr_funnel" },
        "g": [ "tr_funnel", { "trap": "tr_brazier" } ]
      },
      "fields": {
        "B": { "field": "fd_blood", "density": 1, "age": 10 }
      },
      "place_fields": [
        { "x": 5, "y": 1, "field": "fd_bile", "density": 2, "age": 20 }
      ],
      "place_signs": [
        { "signage": "it works again.", "x": 7, "y": 1 },
        { "signage": "<given_name> <family_name> owned <full_name> at <city>", "x": 7, "y": 2 },
        { "snippet": "mapgen_test", "x": 8, "y": 2 },
        { "signage": "<given_name>, <given_name>, and <given_name> were here!", "x": 8, "y": 1 }
      ],
      "signs": {
        "S": { "signage": "it works." }
      },
      "place_vendingmachines": [
        { "x": 3, "y": 1, "item_group": "jewelry_front" }
      ],
      "vendingmachines": {
        "V": { "item_group": "farming_seeds" }
      },
      "place_toilets": [
        { "x": 9, "y": 1, "amount": [ 88, 111 ] }
      ],
      "toilets": {
        "T": { "amount": [ 44, 46 ] }
      },
      "gaspumps": {
        "O": { "amount": [ 110, 112 ] }
      },
      "place_gaspumps": [
        { "x": 1, "y": 1, "amount": [ 200, 222 ] }
      ],
      "items": {
        "o": { "item": "clothing_work_set", "chance": 20 },
        "s": { "item": "bionics_tech", "chance": 70 }
      },
      "place_items": [
        { "x": 1, "y": 3, "item": "bionics_tech", "chance": 70 },
        { "x": 2, "y": 3, "item": "clothing_work_set", "chance": 20 }
      ],
      "add": [
        { "x": [ 0, 7 ], "y": [ 4, 5 ], "item": "frame", "chance": 4, "repeat": 10 }
      ],
      "item": {
        "t": { "item": "television", "chance": 4 },
        "u": [ { "item": "television", "chance": 1 }, { "item": "electrohack", "chance": 1 } ]
      },
      "npcs": {
        "T": { "class": "guard" }
      },
      "place_npcs": [
        { "x": 9, "y": 1, "class": "arsonist" }
      ],
      "monsters": {
        "B": { "monster": "GROUP_BEE", "chance": 4, "density": 1 },
        "S": { "monster": "GROUP_ANT", "chance": 1, "density": 0.1 }
      },
      "place_monsters": [
        { "x": 5, "y": 1, "monster": "GROUP_BEE", "chance": 4, "density": 1 },
        { "x": 7, "y": 1, "monster": "GROUP_ANT", "chance": 1, "density": 0.1 }
      ],
      "monster": {
        "Y": { "monster": "mon_deer", "friendly": true, "name": "THE DEER" }
      },
      "place_monster": [
        { "x": 13, "y": 3, "monster": "mon_deer", "friendly": true, "name": "THE OTHER DEER" }
      ],
      "place_vehicles": [
        { "x": 5, "y": 3, "vehicle": "unicycle", "chance": 100, "status": 1 }
      ],
      "vehicles": {
        "o": { "vehicle": "welding_cart", "chance": 100, "fuel": 40, "status": 1 },
        "s": { "vehicle": "wheelchair", "chance": 100, "status": 1 }
      }
    }
  }
]
